TTT	F
TTC	F
TTA	L
TTG	L
TCT	S
TCC	S
TCA	S
TCG	S
TAT	Y
TAC	Y
TAA	_
TAG	_
TGT	C
TGC	C
TGA	_
TGG	W
CTT	L
CTC	L
CTA	L
CTG	L
CCT	P
CCC	P
CCG	P
CCA	P
CAT	H
CAC	H
CAA	Q
CAG	Q
CGT	R
CGC	R
CGG	R
CGA	R
ATT	I
ATC	I
ATA	I
ATG	M
ACT	T
ACC	T
ACA	T
ACG	T
AAT	N
AAC	N
AAA	K
AAG	K
AGT	S
AGC	S
AGA	R
AGG	R
GTT	V
GTC	V
GTA	V
GTG	V
GCT	A
GCC	A
GCA	A
GCG	A
GAT	D
GAC	D
GAA	E
GAG	E
GGT	G
GGC	G
GGA	G
GGG	G
